15 6
###############
#        #   >#
#   #    #    #
#   #    #    #
#<  #         #
###############