15 6
###############
#             #
#   #######   #
#   #     #   #
# @ #     #  =#
#####     #####