15 6
###############
#        #   =#
#   #    #    #
#   #    #    #
#@  #         #
###############