15 8
###############
#             #
#   #######   #
#   #     #   #
#   #  # =#   #
#   #  ####   #
# @ #         #
###############