15 9
###############
# @        @  #
#   ##   ##   #
#   #     #   #
#      =      #
#   #     #   #
#   ##   ##   #
# @        @  #
###############